%%%%%%%%%%%%%%%%%%%%%%%%%%%%%%%%%%%%%%%%%%%%%%%%%%%
%             %          P%         %             %
% %%% %%%%%%% % %%%%%%%%% % % %%%%% % %%%%% %%%%% %
%   %     % % %   %     %   % %   % % % %   %   % %
%%% %%%%% % % %%%%% %%% %%%%% % % %%% % % %%%%% % %
%   %   % % %   %   % %     % % %   %   %     % % %
% %%%%% % % %%% % %%% %%%%% % % %%% %%% %%%%% % % %
%       % %       %       % % %   %         % %   %
%%% %%%%% %%%%%%%%% %%%%%%% % % %%%%%%% %%%%% % %%%
%   %   %     %     %       %   %     % %     % % %
% %%% % % %%% % %%% % %%%%%%%%%%% %%% %%% %%%%% % %
% %   % %   % %   %   %     %     % %   %   %   % %
% % %%% %%%%% %%% %%%%% %%% % %%%%% %%% %%% % %%% %
% % %   %     % %     %   %   %     %       %     %
%%% % %%% %%%%% %%%%% % % %%%%%%%%% % %%%%%%%%%%% %
%   %     %   %     % % %     %   % % %     %   % %
% %%%%%%%%% %%% %%% % % %%%%% % % % % % %%% % %%% %
%   %           % %   % %   %   % %   % %   %     %
%%% %%%%% %%%%%%% %%%%% % % %%%%% %%%%% % %%%%%%% %
%   %   % %       %       % %   %       %       % %
% %%% % % %%% %%% %%%%%%% %%% % %%%%%%%%%%% %%% % %
%     % %   %   %     % % %   %           % % % % %
% %%%%% %%% %%% %%%%% % % % %%%%%%%%%%%%% % % % %%%
% %     % %     % %   %   % %     %     % % % %   %
%%% %%%%% %%%%%%% % %%%%%%% % %%% % % %%% % % %%% %
% % %       %       %       % % %   %   % %     % %
% % %%%%% %%% %%%%%%% %%%%%%% % %%%%%%% % %%%%%%% %
%   %     %   %       %     %   %   %   % %       %
%%%%% %%% % %%%%% %%%%% %%%%%%% %%% % %%% % %%%%% %
%     %   %     % %   %       %     %     %   %   %
% %%%%%%%%%%%%% % % % % %%% % %%%%% %%%%%%%%% % %%%
%             % % % %   % % % %     %         %   %
% %%%%%%%%%%% % % %%%%% % % %%% %%%%%%% %%%%%%%%% %
% %     %   % % % %   %   %   %     %   %       % %
% % %%% %%% % % % % % % %%%%% %%%%% % %%%%%%% %%% %
% % %       % % %   % % %     %     % %     %   % %
% % %%%%%%%%% % %%% % %%% %%% % %%%%% % %%% %%% % %
% %   %   %   %   % %   % %   % %     % %   %   % %
% %%% % % % % %%% % %%% % % %%% % %%% % % %%% %%% %
%     % %   %   % %   % % %   % % %   % %   % %   %
%%%%% % %%% %%%%% %%%%% % %%% % %%% % % %%% % % %%%
% %   % %   %   %     % %   % %   % % % % % %   % %
% % %%% % %%% % %%%%% % % % %%%%% % %%% % % %%% % %
%     % % %   %       % % %     % %       %   %   %
%%%%%%% % % %%%%%%%%%%% % %%%%% % % %%%%%%%%% %%%%%
%       % %       %     % %     % %   %     %     %
% %%%%%%%%%%%%%%% %%%%% % % %%%%% %%%%% %%% %%%%% %
% %   %   %     % %     % %     %       % % %     %
% % % % % % %%% % % %%%%% %%%%% %%%%%%%%% % % %%% %
%   %   %     %     %     .   %               %   %
%%%%%%%%%%%%%%%%%%%%%%%%%%%%%%%%%%%%%%%%%%%%%%%%%%%
