%%%%%%%%%%%
% P       %
% % % %%% %
% % %   % %
% % %%% % %
% %     % %
% %%%%%%% %
% %     % %
% %%% % % %
%   % % % %
%%% % % % %
%   % % % %
%%%%% % % %
%   % % % %
% % % %%% %
% %   %   %
% %%% % %%%
%   % %   %
% % %%%%% %
% %      .%
%%%%%%%%%%%
