%%%%%
%P  %
%%% %
%   %
% %%%
%   %
%%%.%
%%%%%
